1111111111111
1C000000000C1
10000010C0001
1P00001CEC001
1111111111111