1111111111111
1C000000000C1
1000001000001
1P000010E0001
1111111111111
