1111111111111
1C000000000C1
1000001000001
1P00001E00001
1111111111111
