1111111111111
10010000I00C1
10I0011001001
1P0011E000001
1111111111111
